#########
#  @    #
#  OXXO #
#       #
#########