          #######
          #  XXX#
      #####  XXX#
      #      X X#
      #  ##  XXX#
      ## ##  XXX#
     ### ########
     # OOO ##
 #####  O O #####
##   #O O   #   #
#@ O  O    O  O #
###### OO O #####
     #      #
     ########