          ####
     #### #  #
   ### @###O #
  ##      O  #
 ##  O OO## ##
 #  #O##     #
 # # O OO # ###
 #   O #  # O #####
####    #  OO #   #
#### ## O         #
#X    ###  ########
#XX XX# ####
#XXX#X#
#XXXXX#
#######