################
#              #
# # ######     #
# #  O O O O#  #
# #   O@O   ## ##
# #  O O O###XXX#
# #   O O  ##XXX#
# ###OOO O ##XXX#
#     # ## ##XXX#
#####   ## ##XXX#
    #####     ###
        #     #
        #######