   #########
  ##   ##  #####
###     #  #    ###
#  O #O #  #  XXX #
# # O#@O## # #X#X #
#  # #O  #    X X #
# O    O # # #X#X #
#   ##  ##O O X X #
# O #   #  #O#X#X #
## O  O   O  OXXX #
 #O ######    ##  #
 #  #    ##########
 ####