       #######
 #######     #
 #     # O@O #
 #OO #   #########
 # ###XXXXXX##   #
 #   OXXXXXX## # #
 # ###XXXXXX     #
##   #### ### #O##
#  #O   #  O  # #
#  O OOO  # O## #
#   O O ###OO # #
#####     O   # #
    ### ###   # #
      #     #   #
      ########  #
             ####