   ########
   #   #  #
   #  O   #
 ### #O   ####
 #  O  ##O   #
 #  # @ O # O#
 #  #      O ####
 ## ####O##     #
 # O#XXXXX# #   #
 #  OXX**X O# ###
##  #XXXXX#   #
#   ### #######
# OO  #  #
#  #     #
######   #
     #####