#####
#   ##
#    #  ####
# O  ####  #
#  OO O   O#
###@ #O    ##
 #  ##  O O ##
 # O  ## ## X#
 #  #O##O  #X#
 ###   OXX##X#
  #    #X*XXX#
  # OO #XXXXX#
  #  #########
  #  #
  ####