   ##########
   #XX  #   #
   #XX      #
   #XX  #  ####
  #######  #  ##
  #            #
  #  #  ##  #  #
#### ##  #### ##
#  O  ##### #  #
# # O  O  # O  #
# @O  O   #   ##
#### ## #######
   #    #
   ######