     ###########
     #  X  #   #
     # #X    @ #
 ##### ##XX# ####
##  # XX###     ###
# O #XXX   O #  O #
#    XX ##  ## ## #
####O##O# O #   # #
  ## #    #O OO # #
  #  O # #  # O## #
  #               #
  #  ###########  #
  ####         ####