    #####
    #   #
    #O  #
  ###  O##
  #  O O #
### # ## #   ######
#   # ## #####  XX#
# O  O          XX#
##### ### #@##  XX#
    #     #########
    #######