  ######
  #   @####
##### O   #
#   ##    ####
# O #  ##    #
# O #  ##### #
## O  O    # #
## O O ### # #
## #  O  # # #
## # #O#   # #
## ###   # # ######
#  O  #### # #XXXX#
#    O    O   XX#X#
####O  O# O   XXXX#
#       #  ## XXXX#
###################