    ##########
#####        ####
#     #   O  #@ #
# #######O####  ###
# #    ## #  #O XX#
# # O     #  #  #X#
# # O  #     #O XX#
# #  ### ##     #X#
# ###  #  #  #O XX#
# #    #  ####  #X#
# #O   O  O  #O XX#
#    O # O O #  #X#
#### O###    #O XX#
   #    OO ###XXXX#
   #      ## ######
   ########