#########
#       #
#       ####
## #### #  #
## #@##    #
# OOO O  OO#
#  # ## O  #
#  # ##  O ####
####  OOO O#  #
 #   ##   XXXX#
 # #   # #XX X#
 #   # # ##XXX#
 ##### O  #XXX#
     ##   #####
      #####