    #######
    #  #  ####
##### O#O #  ##
#XX #  #  #   #
#XX # O#O #  O####
#X  #     #O  #  #
#XX   O#  # O    #
#XX@#  #O #O  #  #
#XX # O#     O#  #
#XX #  #OO#O  #  ##
#XX # O#  #  O#O  #
#XX #  #  #   #   #
##X ####  #####   #
 ####  ####   #####