###############
#XXXXXXXXXX  X####
#XXXXXXXXXXOOX#  #
###########O #   ##
#      O  O     O #
## ####   #  O #  #
#      #   ##  # ##
#  O#  # ##  ### ##
# O #O###    ### ##
###  O #  #  ### ##
###    O ## #  # ##
 # O  #  O  O O   #
 #  O  O#OOO  #   #
 #  #  O      #####
 # @##  #  #  #
 ##############