 #######
 #  #  #####
##  #  #XXX###
#  O#  #XXX  #
# O #OO XXX  #
#  O#  #XXX X#
#   # O########
##O       O O #
##  #  OO #   #
 ######  ##OO@#
      #      ##
      ########