 #################
 #XXX   #    #   ##
##XXXXX  O## # #O #
#XXXXXX#  O  #    #
#XXXXXX#  #  # #  #
######### O  O O  #
  #     #O##O ##O##
 ##   O    # O    #
 #  ## ### #  ##O #
 # O OO     O  O  #
 # O    O##O ######
 #######  @ ##
       ######