#####
#   ##
# O  #########
## # #       ######
## #   O#O#@  #   #
#  #      O #   O #
#  ### ######### ##
#  ## XX*XXXXX # ##
## ## *X*XX*X* # ##
# O########## ##O #
#  O   O  O    O  #
#  #   #   #   #  #
###################