       ###########
       #   #     #
#####  #     O O #
#   ##### O## # ##
# O ##   # ## O  #
# O  @OO # ##OOO #
## ###   # ##    #
## #   ### #####O#
## #     O  #XXXX#
#  ### ## O #XXXX##
# O   O #   #XXOX #
#  ## O #  ##XXXX #
#####   ######XXX##
    #####    #####