 ###########
 #     ##  #
 #   O   O #
#### ## OO #
#   O #    #
# OOO # ####
#   # # O ##
#  #  #  O #
# O# O#    #
#   XX# ####
####XX O #@#
#XXXXX# O# #
##XXXX#  O #
 ##XX##    #
  ##########