 #########
 #XXXX   ##
 #X#X#  O ##
##XXXX# # @##
# XXXX#  #  ##
#     #O ##O #
## ###  O    #
 #O  O O O#  #
 # #  O O ## #
 #  ###  ##  #
 #    ## ## ##
 #  O #  O  #
 ###O O   ###
   #  #####
   ####