############ ######
#   #    # ###XXXX#
#   OO#   @  XXXXX#
#   # ###   # XXXX#
## ## ###  #  XXXX#
 # O O     # # ####
 #  O O##  #      #
#### #  #### # ## #
#  # #O   ## #    #
# O  O  # ## #   ##
# # O O    # #   #
#  O ## ## # #####
# OO     OO  #
## ## ### O  #
 #    # #    #
 ###### ######