            #####
#####  ######   #
#   ####  O O O #
# O   ## ## ##  ##
#   O O     O  O #
### O  ## ##     ##
  # ##### #####OO #
 ##O##### @##     #
 # O  ###O### O  ##
 # O  #   ###  ###
 # OO O #   OO #
 #     #   ##  #
 #######XX X###
    #XXXXXXXXX#
    #XXXXXXXXX#
    ###########