###########
#XXXXXX   #########
#XXXXXX   #  ##   #
#XX### O    O     #
#XXX O O #   ##   #
#XXX#O#####    #  #
###    #   #O  #O #
  #  OO O O  O##  #
  #  O   #O#O ##O #
  ### ## #    ##  #
   #  O O ## ######
   #    O  O  #
   ##   # #   #
    #####@#####
        ###