      ####
####### @#
#     O  #
#   O## O#
##O#XXX# #
 # OXXX  #
 # #X X# ##
 #   # #O #
 #O  O    #
 #  #######
 ####