    ############
    #          ##
    #  # #OO O  #
    #O #O#  ## @#
   ## ## # O # ##
   #   O #O  # #
   #   # O   # #
   ## O O   ## #
   #  #  ##  O #
   #    ## OO# #
######OO   #   #
#XXXX#  ########
#X#XXX ##
#XXXX   #
#XXXX   #
#########