           #####
          ##   ##
         ##     #
        ##  OO  #
       ## OO  O #
       # O    O #
####   #   OO #####
#  ######## ##    #
#X            OOO@#
#X# ####### ##   ##
#X# #######X #O O##
#XXXXXXXXXXX #    #
##############  O #
             ##  ##
              ####