        #######
    #####  #  ####
    #   #   O    #
 #### #OO ## ##  #
##      # #  ## ###
#  ### O#O  O  O  #
#XXX    # ##  #   #
#XXX#    @ # ### ##
#XXX#  ###  O  O  #
######## ##   #   #
          #########