 #####
 #   #
 # # #######
 #      O@######
 # O ##O ###   #
 # #### O    O #
 # ##### #  #O ####
##  #### ##O      #
#  O#  O  # ## ## #
#         # #XXX# #
######  ###  XXX  #
     #### # #XXX# #
          # ### # #
          #       #
          #########