##### ####
#XXX# #  ####
#XXX###  O  #
#XXXX## O  O###
##XXXX##   O  #
###XXX ## O O #
# ##    #  O  #
#  ## # ### ####
# O # #O  O    #
#  O @ O    O  #
#   # O OO O ###
#  ######  ###
# ##    ####
###