       ####
       #  ##
       #   ##
       # OO ##
     ###O  O ##
  ####    O   #
###  # #####  #
#    # #XXXXO #
# #   O XXXX# #
#  O # #X*XX# #
###  #### ### #
  #### @O  ##O##
     ### O     #
       #  ##   #
       #########