      ############
     ##XX    #   #
    ##XX* O    O #
   ##XX*X# # # O##
   #XX*X# # # O  #
####XXX#  #    # #
#  ## #          #
# @O O ###  #   ##
# O   O   # #   #
###OO   # # # # #
  #   O   # # #####
  # O# #####      #
  #O   #   #    # #
  #  ###   ##     #
  #  #      #    ##
  ####      ######